11111111111
1000000PEC1
11111111111