111111
1000E1
101C01
10P001
111111
