111111111111111111
1111111111100000P1
1110000000000C0001
11E000000000000001
111111111111111111
