111111111111111
1CCPCCC0E000001
100000010000001
111111111111111