11111111111111111
100000PE000000001
11111111111111111