111111
1010E1
1C1111
10P001
111111