111111
1000E1
101111
10P1C1
111111