111111
1C1CE1
111C01
10PC01
111111