111111
1001E1
101C01
10P001
111111
